11111111
1C100001
11100001
1E0000P1
11111111