111111111
10000C001
111000001
10C000001
1000P0001
111100001
1110E0011
111111111
