111111111
10000C001
1110000E1
10C0E0001
100000001
111110001
11110P011
111111111