11111111111111111111
100000000000C0000001
1E000P000C0000000001
100000000000000C0001
11111111111111111111