1111111111111111111
10P00010101000C11E1
10010011111C1111101
10110C0000001100001
1001011101111100001
1001110CC01CC110001
10000C101C0C0C0C011
1111111111111111111