11111111111111111111
110000000000C0000001
1E100P000C0000000011
110000000000000C0001
11111111111111111111