111111111
10000C001
111000001
10C000001
100000001
111110001
11110P011
111111111