11111111111111111111
110001000000C0000001
1E001P100C0000000011
110001000000000C0001
11111111111111111111