11111111111111111111
110001000000C0000001
1E0010100C0000000001
110000000000000C0001
11111111111111111111