111111111111111111111111111111111111111
1C00000000000000000000E0000000000000001
110000000000000000000000000000000000001
1000000000000000000000P0000000000000001
110000000000000000000000000000000000001
110000000000000000000000000000000000001
110000000000000000000000000000000000001
110000000000000000000000000000000000001
110000000000000000000000000000000000001
110000000000000000000000000000000000001
110000000000000000000000000000000000001
110000000000000000000000000000000000001
110000000000000000000000000000000000001
110000000000000000000000000000000000001
110000000000000000000000000000000000001
110000000000000000000000000000000000001
110000000000000000000000000000000000001
110000000000000000000000000000000000001
110000000000000000000000000000000000001
110000000000000000000000000000000000001
110000000000000000000000000000000000001
110000000000000000000000000000000000001
110000000000000000000000000000000000001
110000000000000000000000000000000000001
110000000000000000000000000000000000001
110000000000000000000000000000000000001
110000000000000000000000000000000000001
110000000000000000000000000000000000001
110000000000000000000000000000000000001
110000000000000000000000000000000000001
110000000000000000000000000000000000001
110000000000000000000000000000000000001
110000000000000000000000000000000000001
110000000000000000000000000000000000001
110000000000000000000000000000000000001
110000000000000000000000000000000000001
110000000000000000000000000000000000001
110000000000000000000000000000000000001
110000000000000000000000000000000000001
110000000000000000000000000000000000001
110000000000000000000000000000000000001
110000000000000000000000000000000000001
110000000000000000000000000000000000001
110000000000000000000000000000000000001
110000000000000000000000000000000000001
110000000000000000000000000000000000001
110000000000000000000000000000000000001
110000000000000000000000000000000000001
111111111111111111111111111111111111111